2 0 0 0 0 0 0 0 0 0 0 0 0 0 0 0 0 0 0 4 
2 0 0 0 6 1 7 0 0 0 0 0 0 0 0 0 0 0 0 4 
2 0 0 0 5 9 9 7 0 0 0 0 0 0 0 0 0 0 0 4 
9 7 0 0 0 5 3 3 19 19 19 19 19 19 19 19 19 19 19 9
9 8 0 0 0 0 0 0 0 0 0 0 0 0 0 0 0 0 0 4 
2 0 0 0 0 6 1 7 0 0 0 0 0 0 0 0 0 0 0 4 
2 0 0 0 6 9 9 9 19 19 19 19 1 1 19 19 19 19 19 9
2 0 0 0 4 9 9 8 0 0 0 0 5 8 0 0 0 0 0 4 
9 7 0 0 4 9 8 0 0 0 0 0 0 0 0 0 0 0 0 4 
9 8 0 0 5 8 0 0 0 0 0 0 0 0 0 0 0 0 0 4 
2 0 0 0 0 0 0 0 0 0 0 0 0 6 1 1 1 1 1 9 
9 1 1 1 1 1 1 1 1 1 1 1 1 9 9 9 9 9 9 9 

575 430 1

6
905 400
65 305
215 215
65 55
665 55
760 55