2 0 0 0 0 0 0 0 0 0 0 0 0 0 0 0 0 0 0 4 
2 0 0 0 6 1 7 0 0 0 0 0 0 0 0 0 0 0 0 4 
2 0 0 0 5 9 9 1 20 0 0 17 19 19 19 19 19 19 19 9 
9 7 0 0 0 4 9 2 0 0 0 0 0 0 0 0 0 0 0 4
9 8 0 0 0 4 9 2 0 0 0 0 0 0 0 0 0 0 0 4 
2 0 0 0 0 4 9 2 0 0 0 0 0 0 0 0 0 0 0 4 
2 0 0 0 6 9 9 9 19 19 19 19 1 1 20 0 0 17 19 9
2 0 0 0 4 9 9 8 0 0 0 0 4 2 0 0 0 0 0 4 
9 7 0 0 4 9 8 0 0 0 0 0 4 2 0 0 0 0 0 4 
9 8 0 0 5 8 0 0 0 0 0 0 4 2 0 0 0 0 0 4 
2 0 0 0 0 0 0 0 0 0 0 0 4 9 1 1 1 1 1 9 
9 1 1 1 1 1 1 1 1 1 1 1 9 9 9 9 9 9 9 9 

575 430 1

0

4
200 510 0
250 510 0
50 350 0
50 100 0

1
400 300
600 50
650 150

850 430

900 270

0